
341, 341, 341, 341, 341, 341, 341, 341, 341, 341, 341, 341, 341, 341, 341, 341, 
341, 341, 341, 341, 341, 341, 341, 341, 341, 341, 341, 341, 341, 341, 341, 341, 
341, 341, 341, 341, 341, 341, 341, 341, 341, 341, 341, 341, 341, 341, 341, 341, 
341, 341, 341, 341, 341, 341, 341, 341, 341, 341, 341, 341, 341, 341, 341, 341, 
341, 341, 341, 341, 341, 341, 341, 341, 341, 341, 341, 341, 341, 341, 341, 341, 
341, 341, 341, 341, 341, 341, 341, 341, 341, 341, 341, 341, 341, 341,
341, 0, 0, 0, 0, 0, 0, 0, 0, 0, 0, 0, 0, 0, 0, 0, 
0, 0, 0, 0, 0, 0, 0, 0, 0, 0, 0, 0, 0, 0, 0, 0, 
0, 0, 0, 0, 0, 0, 0, 0, 0, 0, 0, 0, 0, 0, 0, 0, 
0, 0, 0, 0, 0, 0, 0, 0, 0, 0, 0, 0, 0, 0, 0, 0, 
0, 0, 0, 0, 0, 0, 0, 0, 0, 0, 0, 0, 0, 0, 0, 0, 
0, 0, 0, 0, 0, 0, 0, 0, 0, 0, 0, 0, 0, 341,
341, 0, 0, 0, 0, 0, 0, 0, 0, 0, 0, 0, 0, 0, 0, 0, 
0, 0, 0, 0, 0, 0, 0, 0, 0, 0, 0, 0, 0, 0, 0, 0, 
0, 0, 0, 0, 0, 0, 0, 0, 0, 0, 0, 0, 0, 0, 0, 0, 
0, 0, 0, 0, 0, 0, 0, 0, 0, 0, 0, 0, 0, 0, 0, 0, 
0, 0, 0, 0, 0, 0, 0, 0, 0, 0, 0, 0, 0, 0, 0, 0, 
0, 0, 0, 0, 0, 0, 0, 0, 0, 0, 0, 0, 0, 341,
341, 0, 0, 0, 0, 0, 0, 0, 0, 0, 0, 0, 0, 0, 0, 0, 
0, 0, 0, 0, 0, 0, 0, 0, 0, 0, 0, 0, 0, 0, 0, 0, 
0, 0, 0, 0, 0, 0, 0, 0, 0, 0, 0, 0, 0, 0, 0, 0, 
0, 0, 0, 0, 0, 0, 0, 0, 0, 0, 0, 0, 0, 0, 0, 0, 
0, 0, 0, 0, 0, 0, 0, 0, 0, 0, 0, 0, 0, 0, 0, 0, 
0, 0, 0, 0, 0, 0, 0, 0, 0, 0, 0, 0, 0, 341,
341, 0, 0, 0, 0, 0, 0, 0, 0, 0, 0, 0, 0, 0, 0, 0, 
0, 0, 0, 0, 0, 0, 0, 0, 0, 0, 0, 0, 0, 0, 0, 0, 
0, 0, 0, 0, 0, 0, 0, 0, 0, 0, 0, 0, 0, 0, 0, 0, 
0, 0, 0, 0, 0, 0, 0, 0, 0, 0, 0, 0, 0, 0, 0, 0, 
0, 0, 0, 0, 0, 0, 0, 0, 0, 0, 0, 0, 0, 0, 0, 0, 
0, 0, 0, 0, 0, 0, 0, 0, 0, 0, 0, 0, 0, 341,
341, 0, 0, 0, 0, 0, 0, 0, 0, 0, 0, 0, 0, 0, 0, 0, 
0, 0, 0, 0, 0, 0, 0, 0, 0, 0, 0, 0, 0, 0, 0, 0, 
0, 0, 0, 0, 0, 0, 0, 0, 0, 0, 0, 0, 0, 0, 0, 0, 
0, 0, 0, 0, 0, 0, 0, 0, 0, 0, 0, 0, 0, 0, 0, 0, 
0, 0, 0, 0, 0, 0, 0, 0, 0, 0, 0, 0, 0, 0, 0, 0, 
0, 0, 0, 0, 0, 0, 0, 0, 0, 0, 0, 0, 0, 341,
341, 0, 0, 0, 0, 0, 0, 0, 0, 0, 0, 0, 0, 0, 0, 0, 
0, 0, 0, 0, 0, 0, 0, 0, 0, 0, 0, 0, 0, 0, 0, 0, 
0, 0, 0, 0, 0, 0, 0, 0, 0, 0, 0, 0, 0, 0, 0, 0, 
0, 0, 0, 0, 0, 0, 0, 0, 0, 0, 0, 0, 0, 0, 0, 0, 
0, 0, 0, 0, 0, 0, 0, 0, 0, 0, 0, 0, 0, 0, 0, 0, 
0, 0, 0, 0, 0, 0, 0, 0, 0, 0, 0, 0, 0, 341,
341, 0, 0, 0, 0, 0, 0, 0, 0, 0, 0, 0, 0, 0, 0, 0, 
0, 0, 0, 0, 0, 0, 0, 0, 0, 0, 0, 0, 0, 0, 0, 0, 
0, 0, 0, 0, 0, 0, 0, 0, 0, 0, 0, 0, 0, 0, 0, 0, 
0, 0, 0, 0, 0, 0, 0, 0, 0, 0, 0, 0, 0, 0, 0, 0, 
0, 0, 0, 0, 0, 0, 0, 0, 0, 0, 0, 0, 0, 0, 0, 0, 
0, 0, 0, 0, 0, 0, 0, 0, 0, 0, 0, 0, 0, 341,
341, 0, 0, 0, 0, 0, 0, 0, 0, 0, 0, 0, 0, 0, 0, 0, 
0, 0, 0, 0, 0, 0, 0, 0, 0, 0, 0, 0, 0, 0, 0, 0, 
0, 0, 0, 0, 0, 0, 0, 0, 0, 0, 0, 0, 0, 0, 0, 0, 
0, 0, 0, 0, 0, 0, 0, 0, 0, 0, 0, 0, 0, 0, 0, 0, 
0, 0, 0, 0, 0, 0, 0, 0, 0, 0, 0, 0, 0, 0, 0, 0, 
0, 0, 0, 0, 0, 0, 0, 0, 0, 0, 0, 0, 0, 341,
341, 0, 0, 0, 0, 0, 0, 0, 0, 0, 0, 0, 0, 0, 0, 0, 
0, 0, 0, 0, 0, 0, 0, 0, 0, 0, 0, 0, 0, 0, 0, 0, 
0, 0, 0, 0, 0, 0, 0, 0, 0, 0, 0, 0, 0, 0, 0, 0, 
0, 0, 0, 0, 0, 0, 0, 0, 0, 0, 0, 0, 0, 0, 0, 0, 
0, 0, 0, 0, 0, 0, 0, 0, 0, 0, 0, 0, 0, 0, 0, 0, 
0, 0, 0, 0, 0, 0, 0, 0, 0, 0, 0, 0, 0, 341,
341, 0, 0, 0, 0, 0, 0, 0, 0, 0, 0, 0, 0, 0, 0, 0, 
0, 0, 0, 0, 0, 0, 0, 0, 0, 0, 0, 0, 0, 0, 0, 0, 
0, 0, 0, 0, 0, 0, 0, 0, 0, 0, 0, 0, 0, 0, 0, 0, 
0, 0, 0, 0, 0, 0, 0, 0, 0, 0, 0, 0, 0, 0, 0, 0, 
0, 0, 0, 0, 0, 0, 0, 0, 0, 0, 0, 0, 0, 0, 0, 0, 
0, 0, 0, 0, 0, 0, 0, 0, 0, 0, 0, 0, 0, 341,
341, 0, 0, 0, 0, 0, 0, 0, 0, 0, 0, 0, 0, 0, 0, 0, 
0, 0, 0, 0, 0, 0, 0, 0, 0, 0, 0, 0, 0, 0, 0, 0, 
0, 0, 0, 0, 0, 0, 0, 0, 0, 0, 0, 0, 0, 0, 0, 0, 
0, 0, 0, 0, 0, 0, 0, 0, 0, 0, 0, 0, 0, 0, 0, 0, 
0, 0, 0, 0, 0, 0, 0, 0, 0, 0, 0, 0, 0, 0, 0, 0, 
0, 0, 0, 0, 0, 0, 0, 0, 0, 0, 0, 0, 0, 341,
341, 0, 0, 0, 0, 0, 0, 0, 0, 0, 0, 0, 0, 0, 0, 0, 
0, 0, 0, 0, 0, 0, 0, 0, 0, 0, 0, 0, 0, 0, 0, 0, 
0, 0, 0, 0, 0, 0, 0, 0, 0, 0, 0, 0, 0, 0, 0, 0, 
0, 0, 0, 0, 0, 0, 0, 0, 0, 0, 0, 0, 0, 0, 0, 0, 
0, 0, 0, 0, 0, 0, 0, 0, 0, 0, 0, 0, 0, 0, 0, 0, 
0, 0, 0, 0, 0, 0, 0, 0, 0, 0, 0, 0, 0, 341,
349, 349, 0, 0, 0, 0, 0, 0, 0, 0, 0, 0, 0, 0, 0, 0, 
0, 0, 0, 0, 0, 0, 0, 0, 0, 0, 0, 0, 0, 0, 0, 0, 
0, 0, 0, 0, 0, 0, 0, 0, 0, 0, 0, 0, 0, 0, 0, 0, 
0, 0, 0, 0, 0, 0, 0, 0, 0, 0, 0, 0, 0, 0, 0, 0, 
0, 0, 0, 0, 0, 0, 0, 0, 0, 0, 0, 0, 0, 0, 0, 0, 
0, 0, 0, 0, 0, 0, 0, 0, 0, 0, 0, 0, 0, 341,
341, 341, 341, 341, 341, 341, 341, 341, 0, 0, 0, 0, 0, 0, 0, 0, 
0, 0, 0, 0, 0, 0, 0, 0, 0, 0, 0, 0, 0, 0, 0, 0, 
0, 0, 0, 0, 0, 0, 0, 0, 0, 0, 0, 0, 0, 0, 0, 0, 
0, 0, 0, 0, 0, 0, 0, 0, 0, 0, 0, 0, 0, 0, 0, 0, 
0, 0, 0, 0, 0, 0, 0, 0, 0, 0, 0, 0, 0, 0, 0, 0, 
0, 0, 0, 0, 0, 0, 0, 0, 0, 0, 0, 0, 0, 341,
0, 0, 0, 0, 0, 0, 0, 18, 0, 0, 0, 0, 0, 0, 0, 0, 
0, 0, 0, 0, 0, 0, 0, 0, 0, 0, 0, 0, 0, 0, 0, 0, 
0, 0, 0, 0, 0, 0, 0, 0, 0, 0, 0, 0, 0, 0, 0, 0, 
0, 0, 0, 0, 0, 0, 0, 0, 0, 0, 0, 0, 0, 0, 0, 0, 
0, 0, 0, 0, 0, 0, 0, 0, 0, 0, 0, 0, 0, 0, 0, 0, 
0, 0, 0, 0, 0, 0, 0, 0, 0, 0, 18, 18, 18, 18,
0, 18, 0, 0, 0, 18, 0, 18, 18, 18, 0, 0, 0, 0, 0, 0, 
0, 0, 0, 0, 0, 0, 0, 0, 0, 0, 0, 0, 0, 0, 0, 0, 
0, 0, 0, 0, 0, 0, 0, 0, 0, 0, 0, 0, 0, 0, 0, 0, 
0, 0, 0, 0, 0, 0, 0, 0, 0, 0, 0, 0, 0, 0, 0, 0, 
0, 0, 0, 0, 0, 0, 0, 0, 0, 0, 0, 0, 0, 0, 0, 0, 
0, 0, 0, 0, 0, 0, 0, 0, 0, 0, 18, 18, 18, 18,
0, 0, 0, 0, 18, 0, 0, 18, 0, 0, 18, 0, 0, 0, 0, 0, 
0, 0, 0, 0, 0, 0, 0, 0, 0, 0, 0, 0, 0, 0, 0, 0, 
0, 0, 0, 0, 0, 0, 0, 0, 0, 0, 0, 0, 0, 0, 0, 0, 
0, 0, 0, 0, 0, 0, 0, 0, 0, 0, 0, 0, 0, 0, 0, 0, 
0, 0, 0, 0, 0, 0, 0, 0, 0, 0, 0, 0, 0, 0, 0, 0, 
0, 0, 0, 0, 0, 0, 0, 18, 18, 0, 18, 18, 18, 18,
0, 0, 18, 18, 0, 0, 0, 18, 0, 0, 0, 18, 0, 0, 0, 0, 
0, 0, 0, 0, 0, 0, 0, 0, 0, 0, 0, 0, 0, 0, 0, 0, 
0, 0, 0, 0, 0, 0, 0, 0, 0, 0, 0, 0, 0, 0, 0, 0, 
0, 0, 0, 0, 0, 0, 0, 0, 0, 0, 0, 0, 0, 0, 0, 0, 
0, 0, 0, 0, 0, 0, 0, 0, 0, 0, 0, 0, 0, 0, 0, 0, 
0, 18, 18, 18, 18, 0, 0, 0, 0, 0, 18, 18, 18, 18,
0, 18, 18, 0, 0, 0, 18, 18, 0, 0, 0, 0, 18, 0, 0, 0, 
0, 0, 0, 0, 0, 0, 0, 0, 0, 0, 0, 0, 0, 0, 0, 0, 
0, 0, 0, 0, 18, 18, 0, 18, 18, 0, 18, 18, 18, 0, 18, 0, 
0, 18, 0, 0, 0, 18, 18, 0, 0, 0, 0, 18, 0, 0, 0, 0, 
0, 0, 0, 0, 0, 0, 0, 0, 18, 262, 18, 0, 0, 0, 0, 18, 
18, 18, 0, 18, 0, 0, 0, 0, 18, 0, 18, 18, 18, 18,
0, 0, 18, 0, 0, 0, 0, 18, 18, 18, 0, 0, 0, 18, 0, 0, 
0, 0, 0, 0, 0, 0, 0, 0, 0, 0, 0, 0, 0, 0, 0, 0, 
0, 0, 0, 0, 18, 18, 18, 0, 18, 18, 18, 0, 18, 18, 18, 18, 
18, 18, 0, 0, 0, 18, 0, 0, 0, 0, 0, 18, 0, 0, 0, 0, 
0, 0, 0, 0, 0, 0, 0, 0, 18, 0, 0, 18, 18, 0, 0, 0, 
18, 0, 0, 18, 0, 0, 0, 0, 18, 18, 18, 18, 18, 18,
0, 0, 0, 0, 0, 0, 18, 0, 0, 0, 0, 0, 0, 18, 0, 0, 
0, 0, 0, 0, 0, 0, 0, 0, 0, 0, 0, 0, 0, 0, 0, 0, 
0, 0, 0, 0, 18, 18, 18, 18, 0, 18, 0, 18, 0, 0, 18, 0, 
18, 18, 0, 0, 0, 18, 0, 0, 0, 0, 0, 18, 18, 0, 0, 0, 
0, 0, 0, 0, 0, 0, 0, 0, 278, 0, 18, 0, 0, 0, 0, 0, 
18, 0, 0, 18, 0, 0, 0, 0, 0, 0, 18, 18, 18, 18,
0, 0, 18, 0, 0, 0, 0, 18, 0, 18, 18, 0, 0, 18, 0, 0, 
0, 0, 0, 0, 0, 0, 0, 0, 0, 0, 0, 0, 0, 0, 0, 0, 
0, 0, 18, 18, 0, 0, 0, 0, 0, 0, 0, 18, 0, 18, 18, 0, 
0, 0, 18, 18, 0, 18, 18, 18, 0, 18, 18, 18, 18, 0, 0, 0, 
0, 0, 0, 0, 18, 0, 0, 0, 18, 0, 18, 18, 0, 0, 18, 18, 
18, 0, 18, 18, 0, 0, 0, 0, 0, 18, 18, 18, 18, 18,
0, 0, 18, 0, 0, 0, 18, 0, 18, 0, 18, 18, 0, 18, 18, 18, 
0, 0, 0, 0, 0, 0, 0, 0, 0, 0, 0, 0, 0, 0, 0, 0, 
0, 0, 18, 0, 18, 0, 0, 0, 18, 0, 0, 0, 0, 0, 0, 0, 
18, 0, 18, 18, 18, 0, 0, 18, 18, 18, 18, 0, 18, 18, 18, 18, 
18, 18, 0, 0, 18, 0, 18, 18, 0, 0, 18, 18, 0, 18, 0, 18, 
0, 0, 0, 18, 18, 0, 0, 0, 18, 18, 18, 18, 18, 18,
0, 18, 18, 0, 0, 0, 0, 18, 18, 0, 18, 0, 0, 18, 0, 18, 
18, 18, 18, 18, 18, 18, 18, 18, 18, 0, 0, 0, 0, 0, 0, 0, 
18, 18, 0, 18, 18, 0, 0, 0, 0, 0, 0, 0, 0, 0, 0, 18, 
0, 0, 0, 18, 0, 0, 0, 18, 0, 18, 0, 0, 0, 0, 0, 0, 
0, 18, 18, 18, 18, 18, 0, 18, 0, 0, 0, 0, 18, 0, 18, 0, 
18, 0, 0, 18, 18, 0, 0, 18, 0, 18, 18, 18, 18, 18,
0, 0, 0, 0, 18, 0, 0, 18, 18, 18, 18, 0, 0, 0, 18, 18, 
0, 0, 0, 0, 0, 0, 0, 0, 0, 18, 18, 18, 18, 18, 18, 18, 
0, 18, 0, 18, 18, 18, 0, 18, 0, 0, 0, 0, 0, 0, 18, 0, 
18, 0, 0, 0, 0, 0, 0, 0, 0, 18, 0, 0, 0, 18, 18, 0, 
18, 18, 18, 18, 0, 0, 18, 0, 0, 0, 18, 18, 0, 18, 18, 0, 
0, 0, 0, 18, 18, 0, 0, 18, 0, 18, 18, 18, 18, 18,
0, 0, 0, 0, 0, 18, 18, 0, 0, 18, 0, 18, 18, 18, 18, 0, 
0, 0, 0, 0, 0, 0, 0, 0, 0, 0, 18, 18, 0, 18, 0, 0, 
0, 18, 18, 0, 0, 18, 18, 18, 0, 18, 0, 18, 18, 0, 0, 0, 
0, 0, 0, 0, 0, 18, 18, 18, 18, 18, 0, 0, 0, 0, 0, 0, 
0, 18, 18, 0, 0, 18, 18, 18, 0, 0, 18, 18, 18, 18, 0, 0, 
0, 18, 0, 18, 18, 18, 18, 0, 0, 18, 18, 18, 18, 18,
0, 0, 0, 18, 0, 0, 18, 18, 18, 18, 0, 0, 0, 0, 0, 18, 
18, 18, 0, 18, 0, 0, 0, 0, 0, 0, 18, 0, 18, 18, 18, 0, 
0, 18, 0, 18, 18, 18, 18, 0, 0, 0, 0, 0, 18, 0, 18, 0, 
18, 0, 18, 18, 18, 0, 18, 0, 0, 18, 0, 0, 0, 0, 18, 0, 
18, 0, 18, 18, 0, 0, 18, 18, 0, 0, 18, 18, 18, 18, 0, 0, 
0, 0, 0, 0, 0, 18, 0, 18, 18, 18, 18, 18, 18, 18,
0, 0, 0, 0, 0, 18, 0, 18, 18, 18, 0, 0, 0, 18, 18, 0, 
0, 18, 0, 0, 0, 0, 0, 0, 0, 18, 0, 0, 0, 0, 18, 0, 
0, 0, 0, 0, 0, 0, 0, 0, 0, 0, 18, 18, 18, 18, 0, 18, 
0, 0, 0, 18, 18, 0, 18, 0, 0, 18, 0, 18, 0, 18, 18, 0, 
18, 0, 0, 0, 0, 0, 18, 0, 0, 18, 0, 18, 0, 0, 18, 0, 
0, 0, 0, 0, 0, 0, 18, 18, 18, 18, 18, 18, 18, 18,
0, 0, 0, 0, 0, 0, 0, 0, 0, 0, 18, 18, 18, 18, 0, 18, 
0, 0, 18, 0, 18, 0, 0, 0, 18, 0, 0, 18, 18, 18, 0, 0, 
0, 0, 0, 0, 0, 18, 0, 0, 0, 18, 18, 0, 0, 0, 0, 18, 
18, 0, 18, 0, 18, 0, 18, 18, 18, 18, 0, 18, 18, 18, 0, 0, 
18, 0, 0, 0, 0, 0, 0, 18, 0, 0, 18, 18, 0, 18, 18, 0, 
18, 0, 18, 18, 18, 18, 18, 0, 18, 18, 18, 18, 18, 18,
0, 0, 0, 0, 0, 0, 0, 0, 0, 18, 18, 0, 0, 0, 0, 0, 
0, 0, 0, 0, 0, 0, 18, 0, 18, 0, 0, 0, 18, 18, 18, 0, 
0, 18, 0, 0, 18, 0, 0, 0, 0, 0, 0, 0, 0, 0, 18, 18, 
0, 0, 18, 0, 0, 0, 0, 0, 0, 18, 18, 0, 18, 0, 0, 18, 
0, 0, 0, 0, 0, 0, 18, 18, 18, 18, 18, 0, 0, 18, 0, 0, 
0, 0, 0, 0, 0, 0, 0, 0, 18, 18, 18, 18, 18, 18,
0, 0, 0, 0, 0, 0, 0, 0, 0, 0, 18, 18, 18, 18, 0, 18, 
18, 18, 18, 0, 18, 0, 0, 0, 0, 18, 0, 0, 18, 0, 18, 0, 
18, 18, 18, 18, 18, 18, 18, 18, 0, 0, 18, 0, 0, 0, 0, 0, 
18, 18, 18, 0, 18, 18, 18, 18, 18, 18, 0, 18, 0, 0, 0, 0, 
0, 0, 18, 0, 18, 18, 18, 18, 0, 0, 18, 18, 0, 0, 0, 0, 
0, 0, 0, 0, 0, 0, 0, 18, 18, 18, 18, 18, 18, 18


